 _________________________        _________________________
|                         |       |                        |
|                         |       |                        |
|                                                          |
|                                                          |
|              [GE]                                        |
|__ __                                                __ __|
                                                          
                                                      
 __ __                      [PV]                      __ __
|                                                          |
|                                                          |
|                                                          |
|                                                          |
|                         |======|                         |
|_________________________|======|_________________________|